14 14
+____________+
|0H|00H00T0T0|
|T0|-X---X0TT|
|__+0I000IT0T|
|0000IB00I0T0|
|0000I000IT00|
|0000I000I0TT|
|0000I000I0T0|
|0X--X---X-X0|
|0I00000+__0_|
|0IT0T0T|T000|
|0H000H0|T0B0|
|T0T0000|T00T|
+____________+